20
12
1
7
...#................
...#.........##.#...
........##......#...
...#........#...#...
...#.....#..#...#...
...#.....#......#...
...#.....#..#...#...
............#...#...
.....#......#...#...
..#......###....#...
................#...
####################
