10
8
3
3
..........
..........
..........
..#.......
..#.......
......#...
..#.......
######$$##
..........
..........
1
{
    1
    1
    1
    0.5
    0.5
}
