10
10
3
3
..........
..........
........F.
..#.......
..#.......
......#...
..#.......
######$$##
..........
..........
1
{
    1
    4.5
    3.5
    2.5
    2.5
}
