0
20
13
1
7
...#....#...........
...#....#....##.#...
##......##......#...
...#.....L..S...#...
#..#.....R..S...L...
L..###...R......R...
R..#LL...S..S...R...
R....R......S...S...
R.#..R......S...S...
..#.........S...S...
..#.............S...
##................#.
##................F.
1
{
    1
    9.5
    12.5
    6
    6
    0
    0
}
