10
10
0
6
..........
..........
........F.
..#.......
..#.......
......#...
..#.......
######$$##
..........
..........
1
{
    1
    4.5
    3.5
    2.5
    2.5
    0
    0
}
