0
20
12
1
7
...#................
...#.........##.#...
........##......#...
...#........#...#...
...#.....#..#...#...
...#.....#......#...
...#.....#..#...#...
............#...#...
.....#......#...L...
..#......###....R...
...............LR.F.
#############RRRRRR#
3
{
    1
    3.5
    3.5
    4
    4
    0
    0
}
{
    1
    10
    6
    3
    3
    0
    1
}
{
    1
    16.5
    3.5
    3.5
    3.5
    0
    0
}
