1
25
16
2
2
.........................
........SS...............
.........................
..#..........S.........F.
........................
.......S.................
.........................
.S.......................
.........................
.........................
......S..................
$$.....................$$
RR$$................$$$RR
RRRR$$$$$$$$$$$$$$$$RRRRR
RRRRRRRRRRRRRRRRRRRRRRRRR
RRRRRRRRRRRRRRRRRRRRRRRRR
1
{
    1
    8
    2
    3
    3
    0
    0
}   
