10
8
3
3
..........
..........
..........
..........
..........
......#...
....#.....
##########
