10
10
3
3
..........
..........
..........
..#.......
..#.......
......#...
..#.......
##########
