20
13
1
7
...#....#...........
...#....#....##.#...
##......##......#...
...#.....#..#...#...
#..#.....#..#...#...
#..###...#......#...
#..###...#..#...#...
#....#......#...#...
#.#..#......#...#...
..#.........#...#...
..#.............#...
##................#.
##................F.
1
{
    1
    1.5
    1.5
    0.5
    0.5
}
