20
12
1
7
...#....#...........
...#....#....##.#...
##......##......#...
...#.....#..#...#...
#..#.....#..#...#...
#..###...#......#...
#..###...#..#...#...
#....#......#...#...
#.#..#......#...#...
..#.........#...#...
..#.............#...
##................#.
0
